#######################################/
#.....................................#/
#.....................................#/
#.....................................#/
#.....................................#/
#.....................................#/
#.....................................#/
#.....................................#/
#.....................................#/
#.....................................#/
#.....................................#/
#.....................................#/
#.....................................#/
#.....................................#/
#.....................................#/
#.....................................#/
#.....................................#/
#.....................................#/
#.....................................#/
#.....................................#/
#.....................................#/
#.....................................#/
#.....................................#/
#.....................................#/
#.....................................#/
#................X....................#/
#.....................................#/
#.....................................#/
#.....................................#/
#######################################/

